111111111111111111111
100100000001000000001
10000P000C00011111111
1000110000000000E0001
111111111111111111111