111111111111111111111
10010C000001000000001
10C00P000000011111111
1000110000C000E000001
111111111111111111111