111111111111111111111
10010C000001000000S01
10C00P000000011111111
1000110000C000E000001
111111111111111111111

