111111111111111
100000000000101
100CC00E110P001
1001CC00C000001
1001CC001000111
100011111101001
100110000000011
100110000C00011
1001100CC000001
100000000000101
100CC00E1100001
1001CC00C000001
1001CC001000111
100011111101001
100110000C00011
1001100CC000001
111111111111111