111111111111111
10000P000000001
100CC00E1100001
111111111111111