111111111111111111111
10010C0S000C1000S0001
1000011111001000C0S01
1P0011E000C000C000001
111111111111111111111