111111111111111111111
10010000000C100000001
1000011111001000C0S01
1P0011E00000000000001
111111111111111111111
111111111111111111111