111111111111111111111
10010000000C100000001
1000011111001000C00S1
1P0011E00000000000C01
111111111111111111111