111111111111111111111
10010000000C1000SCS01
10000111110010S0C0001
1P0011E000C000C000001
111111111111111111111