111111
111111
111111111111
111111
111111111111
111111
111111111111
111111
111111111111
111111
111111111111
111111
111111111111
111111
111111111111
111111
111111111111
111111
111111111111
111111
111111111111
111111
111111111111
111111
111111111111
111111
111111111111
111111
111111111111
111111
111111111111
111111
111111111111
111111
111111111111
111111
111111111111
111111
111111111111
111111
111111111111
111111
111111111111
111111
111111111111
111111
111111111111
111111
111111111111
111111
111111111111
111111
111111111111
111111
111111111111
111111
111111111111
111111
111111111111
111111
111111111111
111111
111111111111
111111
111111111111
111111
111111111111
111111
111111111111
111111
111111111111
111111
111111111111
111111
111111111111
111111
111111111111
111111
111111111111
111111
111111111111
111111
111111111111
111111
111111111111
111111
111111111111
111111
111111111111
111111
111111111111
111111
111111111111
111111
111111111111
111111
111111111111
111111
111111111111
111111
111111111111
111111
111111111111
111111
111111111111
111111
111111111111
111111
111111111111
111111
111111111111
111111
111111111111
111111
111111111111
111111
111111111111
111111
111111111111
111111
111111111111
111111
111111111111
111111
111111111111
111111
111111111111
111111
111111111111
111111
111111111111
111111
111111111111
111111
111111111111
111111
111111111111
111111
111111111111
111111
111111111111
111111
111111111111
111111
111111111111
111111
111111111111
111111
111111111111
111111
111111111111
111111
111111111111
111111
111111111111
111111
111111111111
111111
111111111111
111111
111111111111
111111
111111111111
111111
111111111111
111111
111111111111
111111
111111111111
111111
111111111111
111111
111111111111
111111
111111111111
111111
111111111111
111111
111111111111
111111
111111111111
111111
111111111111
111111
111111111111
111111
111111111111
111111
111111111111
111111
111111111111
111111
111111111111
111111
111111111111
111111
111111111111
111111
111111111111
111111
111111111111
111111
111111111111
111111
111111111111
111111
111111111111
111111
111111111111
111111
111111111111
111111
111111111111
111111
111111111111
111111
111111111111
111111
111111111111
111111
111111111111
111111
111111111111
111111
111111111111
111111
111111111111
111111
111111111111
111111
111111111111
111111
111111111111
111111
111111111111
111111
111111111111
111111
111111111111
111111
111111111111
111111
111111111111
111111
111111111111
111111
111111111111
111111
111111111111
111111
111111111111
111111
111111111111
111111
111111111111
111111
111111111111
111111
111111111111
111111
111111111111
111111
111111111111
111111
111111111111
111111
111111111111
111111
111111111111
111111
111111111111
111111
111111111111
111111
111111111111
111111
111111111111
111111
111111111111
111111
111111111111
111111
111111111111
111111
111111111111
111111
111111111111
111111
111111111111
111111
111111111111
111111
111111111111
111111
111111111111
111111
111111111111
111111
111111111111
111111
111111111111
111111
111111111111
111111
111111111111
111111
111111111111
111111
111111111111
111111
111111111111
111111
111111111111
111111
111111111111
111111
111111111111
111111
111111111111
111111
111111111111
111111
111111111111
111111
111111111111
111111
111111111111
111111
111111111111
111111
111111111111
111111
111111111111
111111
111111111111
111111
111111111111
111111
111111111111
111111
111111111111
111111
111111111111
111111
111111111111
111111
111111111111
111111
111111111111
111111
111111111111
111111
111111111111
111111
111111111111
111111
111111111111
111111
111111111111
111111
111111111111
111111
111111111111
111111
111111111111
111111
111111111111
111111
111111111111
111111
111111111111
111111
111111111111
111111
111111111111
111111
111111111111
111111
111111111111
111111
111111111111
111111
111111111111
111111
111111111111
111111
111111111111
111111
111111111111
111111
111111111111
111111
111111111111
111111
111111111111
111111
111111111111
111111
111111111111
111111
111111111111
111111
111111111111
111111
111111111111
111111
111111111111
111111
111111111111
111111
111111111111
111111
111111111111
111111
111111111111
111111
111111111111
111111
111111111111
111111
111111111111
111111
111111111111
111111
111111111111
111111
111111111111
111111
111111111111
111111
111111111111
111111
111111111111
111111
111111111111
111111
111111111111
111111
111111111111
111111
111111111111
111111
111111111111
111111
111111111111
111111
111111111111
111111
111111111111
111111
111111111111
111111
111111111111
111111
111111111111
111111
111111111111
111111
111111111111
111111
111111111111
111111
111111111111
111111
111111111111
111111
111111111111
111111
111111111111
111111
111111111111
111111
111111111111
111111
111111111111
111111
111111111111
111111
111111111111
111111
111111111111
111111
111111111111
111111
111111111111
111111
111111111111
111111
111111111111
111111
111111111111
111111
111111111111
111111
111111111111
111111
111111111111
111111
111111111111
111111
111111111111
111111
111111111111
111111
111111111111
111111
111111111111
111111
111111111111
111111
111111111111
111111
111111111111
111111
111111111111
111111
111111111111
111111
111111111111
111111
111111111111
111111
111111111111
111111
111111111111
111111
111111111111
111111
111111111111
111111
111111111111
111111
111111111111
111111
111111111111
111111
111111111111
111111
111111111111
111111
111111111111
111111
111111111111
111111
111111111111
111111
111111111111
111111
111111111111
111111
111111111111
111111
111111111111
111111
111111111111
111111
111111111111
111111
111111111111
111111
111111111111
111111
111111111111
111111
111111111111
111111
111111111111
111111
111111111111
111111
111111111111
111111
111111111111
111111
111111111111
111111
111111111111
111111
111111111111
111111
111111111111
111111
111111111111
111111
111111111111
111111
111111111111
111111
111111111111
111111
111111111111
111111
111111111111
111111
111111111111
111111
111111111111
111111
111111111111
111111
111111111111
111111
111111111111
111111
111111111111
111111
111111111111
111111
111111111111
111111
111111111111
111111
111111111111
111111
111111111111
111111
111111111111
111111
111111111111
111111
111111111111
111111
111111111111
111111
111111111111
111111
111111111111
111111
111111111111
111111
111111111111
111111
111111111111
111111
111111111111
111111
111111111111
111111
111111111111
111111
111111111111
111111
111111111111
111111
111111111111
111111
111111111111
111111
111111111111
111111
111111111111
111111
111111111111
111111
111111111111
111111
111111111111
111111
111111111111
111111
111111111111
111111
111111111111
111111
111111111111
111111
111111111111
111111
111111111111
111111
111111111111
111111
111111111111
111111
111111111111
111111
111111111111
111111
111111111111
111111
111111111111
111111
111111111111
111111
111111111111
111111
111111111111
111111
111111111111
111111
111111111111
111111
111111111111
111111
111111111111
111111
111111111111
111111
111111111111
111111
111111111111
111111
111111111111
111111
111111111111
111111
111111111111
111111
111111111111
111111
111111111111
111111
111111111111
111111
111111111111
111111
111111111111
111111
111111111111
111111
111111111111
111111
111111111111
111111
111111111111
111111
111111111111
111111
111111111111
111111
111111111111
111111
111111111111
111111
111111111111
111111
111111111111
111111
111111111111
111111
111111111111
111111
111111111111
111111
111111111111
111111
111111111111
111111
111111111111
111111
111111111111
111111
111111111111
111111
111111111111
111111
111111111111
111111
111111111111
111111
111111111111
111111
111111111111
111111
111111111111
111111
111111111111
111111
111111111111
111111
111111111111
111111
111111111111
111111
111111111111
111111
111111111111
111111
111111111111
111111
111111111111
111111
111111111111
111111
111111111111
111111
111111111111
111111
111111111111
111111
111111111111
111111
111111111111
111111
111111111111
111111
111111111111
111111
111111111111
111111
111111111111
111111
111111111111
111111
111111111111
111111
111111111111
111111
111111111111
111111
111111111111
111111
111111111111
111111
111111111111
111111
111111111111
111111
111111111111
111111
111111111111
111111
111111111111
111111
111111111111
111111
111111111111
111111
111111111111
111111
111111111111
111111
111111111111
111111
111111111111
111111
111111111111
111111
111111111111
111111
111111111111
111111
111111111111
111111
111111111111
111111
111111111111
111111
111111111111
111111
111111111111
111111
111111111111
111111
111111111111
111111
111111111111
111111
111111111111
111111
111111111111
111111
111111111111
111111
111111111111
111111
111111111111
111111
111111111111
111111
111111111111
111111
111111111111
111111
111111111111
111111
111111111111
111111
111111111111
111111
111111111111
111111
111111111111
111111
111111111111
111111
111111111111
111111
111111111111
111111
111111111111
111111
111111111111
111111
111111111111
111111
111111111111
111111
111111111111
111111
111111111111
111111
111111111111
111111
111111111111
111111
111111111111
111111
111111111111
111111
111111111111
111111
111111111111
111111
111111111111
111111
111111111111
111111
111111111111
111111
111111111111
111111
111111111111
111111
111111111111
111111
111111111111
111111
111111111111
111111
111111111111
111111
111111111111
111111
111111111111
111111
111111111111
111111
111111111111
111111
111111111111
111111
111111111111
111111
111111111111
111111
111111111111
111111
111111111111
111111
111111111111
111111
111111111111
111111
111111111111
111111
111111111111
111111
111111111111
111111
111111111111
111111
111111111111
111111
111111111111
111111
111111111111
111111
111111111111
111111
111111111111
111111
111111111111
111111
111111111111
111111
111111111111
111111
111111111111
111111
111111111111
111111
111111111111
111111
111111111111
111111
111111111111
111111
111111111111
111111
111111111111
111111
111111111111
111111
111111111111
111111
111111111111
111111
111111111111
111111
111111111111
111111
111111111111
111111
111111111111
111111
111111111111
111111
111111111111
111111
111111111111
111111
111111111111
111111
111111111111
111111
111111111111
111111
111111111111
111111
111111111111
111111
111111111111
111111
111111111111
111111
111111111111
111111
111111111111
111111
111111111111
111111
111111111111
111111
111111111111
111111
111111111111
111111
111111111111
111111
111111111111
111111
111111111111
111111
111111111111
111111
111111111111
111111
111111111111
111111
111111111111
111111
111111111111
111111
111111111111
111111
111111111111
111111
111111111111
111111
111111111111
111111
111111111111
111111
111111111111
111111
111111111111
111111
111111111111
111111
111111111111
111111
111111111111
111111
111111111111
111111
111111111111
111111
111111111111
111111
111111111111
111111
111111111111
111111
111111111111
111111
111111111111
111111
111111111111
111111
111111111111
111111
111111111111
111111
111111111111
111111
111111111111
111111
111111111111
111111
111111111111
111111
111111111111
111111
111111111111
111111
111111111111
111111
111111111111
111111
111111111111
111111
111111111111
111111
111111111111
111111
111111111111
111111
111111111111
111111
111111111111
111111
111111111111
111111
111111111111
111111
111111111111
111111
111111111111
111111
111111111111
111111
111111111111
111111
111111111111
111111
111111111111
111111
111111111111
111111
111111111111
111111
111111111111
111111
111111111111
111111
111111111111
111111
111111111111
111111
111111111111
111111
111111111111
111111
111111111111
111111
111111111111
111111
111111111111
111111
111111111111
111111
111111111111
111111
111111111111
111111
111111111111
111111
111111111111
111111
111111111111
111111
111111111111
111111
111111111111
111111
111111111111
111111
111111111111
111111
111111111111
111111
111111111111
111111
111111111111
111111
111111111111
111111
111111111111
111111
111111111111
111111
111111111111
111111
111111111111
111111
111111111111
111111
111111111111
111111
111111111111
111111
111111111111
111111
111111111111
111111
111111111111
111111
111111111111
111111
111111111111
111111
111111111111
111111
111111111111
111111
111111111111
111111
111111111111
111111
111111111111
111111
111111111111
111111
111111111111
111111
111111111111
111111
111111111111
111111
111111111111
111111
111111111111
111111
111111111111
111111
111111111111
111111
111111111111
111111
111111111111
111111
111111111111
111111
111111111111
111111
111111111111
111111
111111111111
111111
111111111111
111111
111111111111
111111
111111111111
111111
111111111111
111111
111111111111
111111
111111111111
111111
111111111111
111111
111111111111
111111
111111111111
111111
111111111111
111111
111111111111
111111
111111111111
111111
111111111111
111111
111111111111
111111
111111111111
111111
111111111111
111111
111111111111
111111
111111111111
111111
111111111111
111111
111111111111
111111
111111111111
111111
111111111111
111111
111111111111
111111
111111111111
111111
111111111111
111111
111111111111
111111
111111111111
111111
111111111111
111111
111111111111
111111
111111111111
111111
111111111111
111111
111111111111
111111
111111111111
111111
111111111111
111111
111111111111
111111
111111111111
111111
111111111111
111111
111111111111
111111
111111111111
111111
111111111111
111111
111111111111
111111
111111111111
111111
111111111111
111111
111111111111
111111
111111111111
111111
111111111111
111111
111111111111
111111
111111111111
111111
111111111111
111111
111111111111
111111
111111111111
111111
111111111111
111111
111111111111
111111
111111111111
111111
111111111111
111111
111111111111
111111
111111111111
111111
111111111111
111111
111111111111
111111
111111111111
111111
111111111111
111111
111111111111
111111
111111111111
111111
111111111111
111111
111111111111
111111
111111111111
111111
111111111111
111111
111111111111
111111
111111111111
111111
111111111111
111111
111111111111
111111
111111111111
111111
111111111111
111111
111111111111
111111
111111111111
111111
111111111111
111111
111111111111
111111
111111111111
111111
111111111111
111111
111111111111
111111
111111111111
111111
111111111111
111111
111111111111
111111
111111111111
111111
111111111111
111111
111111111111
111111
111111111111
111111
111111111111
111111
111111111111
111111
111111111111
111111
111111111111
111111
111111111111
111111
111111111111
111111
111111111111
111111
111111111111
111111
111111111111
111111
111111111111
111111
111111111111
111111
111111111111
111111
111111111111
111111
111111111111
111111
111111111111
111111
111111111111
111111
111111111111
111111
111111111111
111111
111111111111
111111
111111111111
111111
111111111111
111111
111111111111
111111
111111111111
111111
111111111111
111111
111111111111
111111
111111111111
111111
111111111111
111111
111111111111
111111
111111111111
111111
111111111111
111111
111111111111
111111
111111111111
111111
111111111111
111111
111111111111
111111
111111111111
111111
111111111111
111111
111111111111
111111
111111111111
111111
111111111111
111111
111111111111
111111
111111111111
111111
111111111111
111111
111111111111
111111
111111111111
111111
111111111111
111111
111111111111
111111
111111111111
111111
111111111111
111111
111111111111
111111
111111111111
111111
111111111111
111111
111111111111
111111
111111111111
111111
111111111111
111111
111111111111
111111
111111111111
111111
111111111111
111111
111111111111
111111
111111111111
111111
111111111111
111111
111111111111
111111
111111111111
111111
111111111111
111111
111111111111
111111
111111111111
111111
111111111111
111111
111111111111
111111
111111111111
111111
111111111111
111111
111111111111
111111
111111111111
111111
111111111111
111111
111111111111
111111
111111111111
111111
111111111111
111111
111111111111
111111
111111111111
111111
111111111111
111111
111111111111
111111
111111111111
111111
111111111111
111111
111111111111
111111
111111111111
111111
111111111111
111111
111111111111
111111
111111111111
111111
111111111111
111111
111111111111
111111
111111111111
111111
111111111111
111111
111111111111
111111
111111111111
111111
111111111111
111111
111111111111
111111
111111111111
111111
111111111111
111111
111111111111
111111
111111111111
111111
111111111111
111111
111111111111
111111
111111111111
111111
111111111111
111111
111111111111
111111
111111111111
111111
111111111111
111111
111111111111
111111
111111111111
111111
111111111111
111111
111111111111
111111
111111111111
111111
111111111111
111111
111111111111
111111
111111111111
111111
111111111111
111111
111111111111
111111
111111111111
111111
111111111111
111111
111111111111
111111
111111111111
111111
111111111111
111111
111111111111
111111
111111111111
111111
111111111111
111111
111111111111
111111
111111111111
111111
111111111111
111111
111111111111
111111
111111111111
111111
111111111111
111111
111111111111
111111
111111111111
111111
111111111111
111111
111111111111
111111
111111111111
111111
111111111111
111111
111111111111
111111
111111111111
111111
111111111111
111111
111111111111
111111
111111111111
111111
111111111111
111111
111111111111
111111
111111111111
111111
111111111111
111111
111111111111
111111
111111111111
111111
111111111111
111111
111111111111
111111
111111111111
111111
111111111111
111111
111111111111
111111
111111111111
111111
111111111111
111111
111111111111
111111
111111111111
111111
111111111111
111111
111111111111
111111
111111111111
111111
111111111111
111111
111111111111
111111
111111111111
111111
111111111111
111111
111111111111
111111
111111111111
111111
111111111111
111111
111111111111
111111
111111111111
111111
111111111111
111111
111111111111
111111
111111111111
111111
111111111111
111111
111111111111
111111
111111111111
111111
111111111111
111111
111111111111
111111
111111111111
111111
111111111111
111111
111111111111
111111
111111111111
111111
111111111111
111111
111111111111
111111
111111111111
111111
111111111111
111111
111111111111
111111
111111111111
111111
111111111111
111111
111111111111
111111
111111111111
111111
111111111111
111111
111111111111
111111
111111111111
111111
111111111111
111111
111111111111
111111
111111111111
111111
111111111111
111111
111111111111
111111
111111111111
111111
111111111111
111111
111111111111
111111
111111111111
111111
111111111111
111111
111111111111
111111
111111111111
111111
111111111111
111111
111111111111
111111
111111111111
111111
111111111111
111111
111111111111
111111
111111111111
111111
111111111111
111111
111111111111
111111
111111111111
111111
111111111111
111111
111111111111
111111
111111111111
111111
111111111111
111111
111111111111
111111
111111111111
111111
111111111111
111111
111111111111
111111
111111111111
111111
111111111111
111111
111111111111
111111
111111111111
111111
111111111111
111111
111111111111
111111
111111111111
111111
111111111111
111111
111111111111
111111
111111111111
111111
111111111111
111111
111111111111
111111
111111111111
111111
111111111111
111111
111111111111
111111
111111111111
111111
111111111111
111111
111111111111
111111
111111111111
111111
111111111111
111111
111111111111
111111
111111111111
111111
111111111111
111111
111111111111
111111
111111111111
111111
111111111111
111111
111111111111
111111
111111111111
111111
111111111111
111111
111111111111
111111
111111111111
111111
111111111111
111111
111111111111
111111
111111111111
111111
111111111111
111111
111111111111
111111
111111111111
111111
111111111111
111111
111111111111
111111
111111111111
111111
111111111111
111111
111111111111
111111
111111111111
111111
111111111111
111111
111111111111
111111
111111111111
111111
111111111111
111111
111111111111
111111
111111111111
111111
111111111111
111111
111111111111
111111
111111111111
111111
111111111111
111111
111111111111
111111
111111111111
111111
111111111111
111111
111111111111
111111
111111111111
111111
111111111111
111111
111111111111
111111
111111111111
111111
111111111111
111111
111111111111
111111
111111111111
111111
111111111111
111111
111111111111
111111
111111111111
111111
111111111111
111111
111111111111
111111
111111111111
111111
111111111111
111111
111111111111
111111
111111111111
111111
111111111111
111111
111111111111
111111
111111111111
111111
111111111111
111111
111111111111
111111
111111111111
111111
111111111111
111111
111111111111
111111
111111111111
111111
111111111111
111111
111111111111
111111
111111111111
111111
111111111111
111111
111111111111
111111
111111111111
111111
111111111111
111111
111111111111
111111
111111111111
111111
111111111111
111111
111111111111
111111
111111111111
111111
111111111111
111111
111111111111
111111
111111111111
111111
111111111111
111111
111111111111
111111
111111111111
111111
111111111111
111111
111111111111
111111
111111111111
111111
111111111111
111111
111111111111
111111
111111111111
111111
111111111111
111111
111111111111
111111
111111111111
111111
111111111111
111111
111111111111
111111
111111111111
111111
111111111111
111111
111111111111
111111
111111111111
111111
111111111111
111111
111111111111
111111
111111111111
111111
111111111111
111111
111111111111
111111
111111111111
111111
111111111111
111111
111111111111
111111
111111111111
111111
111111111111
111111
111111111111
111111
111111111111
111111
111111111111
111111
111111111111
111111
111111111111
111111
111111111111
111111
111111111111
111111
111111111111
111111
111111111111
111111
111111111111
111111
111111111111
111111
111111111111
111111
111111111111
111111
111111111111
111111
111111111111
111111
111111111111
111111
111111111111
111111
111111111111
111111
111111111111
111111
111111111111
111111
111111111111
111111
111111111111
111111
111111111111
111111
111111111111
111111
111111111111
111111
111111111111
111111
111111111111
111111
111111111111
111111
111111111111
111111
111111111111
111111
111111111111
111111
111111111111
111111
111111111111
111111
111111111111
111111
111111111111
111111
111111111111
111111
111111111111
111111
111111111111
111111
111111111111
111111
111111111111
111111
111111111111
111111
111111111111
111111
111111111111
111111
111111111111
111111
111111111111
111111
111111111111
111111
111111111111
111111
111111111111
111111
111111111111
111111
111111111111
111111
111111111111
111111
111111111111
111111
111111111111
111111
111111111111
111111
111111
